You wake up in a cold room, the floor is stone and you are surrounded by metal bars, it's a cage. Somewhere inside is your friend, you know you have to find him as soon as possible and escape.

Capybara Escape
An Interactive Fiction by Petra
Release 1 / Serial number 260118 / Inform 7 v10.1.2 / D

Capybara Cage
The bars are old but sturdy, in the distance you see light, it's the exit to the performance stage.

>e
Performance Stage
The sandlike ground is littered with objects left behind by the audience. The stage is big enough to do a dance, you can even do a flip!

Some peanut shells and a small pile of peanuts are scattered around.

You can also see an apple and a banana here.

>e
You can't go that way.

I beg your pardon?

I beg your pardon?

>e
You can't go that way.

>e
You can't go that way.

>look
Performance Stage
The sandlike ground is littered with objects left behind by the audience.

Some peanut shells and a small pile of peanuts are scattered around.

You can also see an apple and a banana here.

north: the Hallway
west: the Capybara Cage

* * *

>e
You can't go that way.

>verbose
Capybara Escape is now in its "verbose" mode, which always gives long descriptions of locations (even if you've been there before).

>e
You can't go that way.

>look
Performance Stage
The sandlike ground is littered with objects left behind by the audience.

Some peanut shells and a small pile of peanuts are scattered around.

You can also see an apple and a banana here.

* * *

>e
Performance Stage
The sandlike ground is littered with objects left behind by the audience. The stage is big enough to do a dance, you can even do a flip!

Some peanut shells and a small pile of peanuts are scattered around.

You can also see an apple and a banana here.

>look
Performance Stage
The sandlike ground is littered with objects left behind by the audience.

Some peanut shells and a small pile of peanuts are scattered around.

You can also see an apple and a banana here.

north: the Hallway
west: the Capybara Cage

>take banana
You pick up a ripe banana.

Good thing you can store it in your inventory.

>take apple
You pick up a shiny red apple.

>take peanuts
You scoop up the peanuts.

Taken.

>look
Performance Stage
The sandlike ground is littered with objects left behind by the audience.

north: the Hallway
west: the Capybara Cage

>w
Capybara Cage
The bars are old but sturdy, in the distance you see light, it's the exit to the performance stage.

>e
Performance Stage
The sandlike ground is littered with objects left behind by the audience.

>look
Performance Stage
The sandlike ground is littered with objects left behind by the audience.

north: the Hallway
west: the Capybara Cage

>n
Hallway
A narrow hallway stretches through the circus, dust and dirt covering the floor.

You see something round in the middle of the hallway.

>take round objec
You can't see any such thing.

>take round object
You pick it up-it's a ball.

>i
You are carrying:
  a ball
  some peanuts
  an apple
  a banana

>look
Hallway
A narrow hallway stretches through the circus, dust and dirt covering the floor.

north: the Guard Room
south: the Performance Stage
east: the Old Cage
west: the Storage Room

>e
Old Cage
A small dark cage, there is a old capybara watching you.

You can see an old capybara here.

>ask capybara about key
"No, no," she says. "That won't help me remember."

>give capybara apple
"No, no," she says. "That won't help me remember."

>combine banana and apple
You carefully tie the banana and apple together into a food bundle.

>give capybara food bunfle
I only understood you as far as wanting to give the old capybara the food bundle.

>give capybara food bundle
"Ahh... delicious, this takes me back," she whispers. "The key you seek lies on the guard's table. He will only stand if something distracts him."

>look
Old Cage
A small dark cage, there is a old capybara watching you.

You can see an old capybara here.

west: the Hallway

>w
Hallway
A narrow hallway stretches through the circus, dust and dirt covering the floor.

>look
Hallway
A narrow hallway stretches through the circus, dust and dirt covering the floor.

north: the Guard Room
south: the Performance Stage
east: the Old Cage
west: the Storage Room

>n
Guard Room
A dark wooden table is in the middle of the room, a guard is sitting behind it, half-asleep. There is a small key on the table.

You can see a friends cage door, a metal key and a circus guard here.

>throw ball
The ball hits the wall with a loud thud. The guard stands up to investigate.

>take key
You snatch the key and quickly hide under the table.

>i
You are carrying:
  a metal key
  a ball
  some peanuts

>look
Guard Room
A dark wooden table is in the middle of the room, a guard is sitting behind it, half-asleep. There is a small key on the table.

You can see a friends cage door and a circus guard here.

south: the Hallway
east: the Friend's Cage

>e
The guard catches you immediately. Everything darkens...

Capybara Cage
The bars are old but sturdy, in the distance you see light, it's the exit to the performance stage.

east: the Performance Stage

>i
You are carrying:
  a ball
  some peanuts

>look
Capybara Cage
The bars are old but sturdy, in the distance you see light, it's the exit to the performance stage.

east: the Performance Stage

>e
Performance Stage
The sandlike ground is littered with objects left behind by the audience.

>n
Hallway
A narrow hallway stretches through the circus, dust and dirt covering the floor.

>n
Guard Room
A dark wooden table is in the middle of the room, a guard is sitting behind it, half-asleep. There is a small key on the table.

You can see a metal key, a friends cage door and a circus guard here.

>i
You are carrying:
  a ball
  some peanuts

>take key
You snatch the key and quickly hide under the table.

* * *

>take banana
You pick up a ripe banana.

Good thing you can store it in your inventory.

>take applkke
You can't see any such thing.

>take apple
You pick up a shiny red apple.

* * *

>n
Hallway
A narrow hallway stretches through the circus, dust and dirt covering the floor.

You see something round in the middle of the hallway.

>take round object
You pick it up-it's a ball.

>look
Hallway
A narrow hallway stretches through the circus, dust and dirt covering the floor.

north: the Guard Room
south: the Performance Stage
east: the Old Cage
west: the Storage Room

* * *

>ask capybara about key
"No, no," she says. "That won't help me remember."

>combine apple and banana
You carefully tie the banana and apple together into a food bundle.

>give capybara food bundle
"Ahh... delicious, this takes me back," she whispers. "The key you seek lies on the guard's table. He will only stand if something distracts him."

* * *

>look
Hallway
A narrow hallway stretches through the circus, dust and dirt covering the floor.

north: the Guard Room
south: the Performance Stage
east: the Old Cage
west: the Storage Room

>w
Storage Room
Old costumes and props surround you everywhere.

Something reflective catches your eye among the props.

>take reflective object
It's a small mirror.

>look
Storage Room
Old costumes and props surround you everywhere.

east: the Hallway

>e
Hallway
A narrow hallway stretches through the circus, dust and dirt covering the floor.

>look
Hallway
A narrow hallway stretches through the circus, dust and dirt covering the floor.

north: the Guard Room
south: the Performance Stage
east: the Old Cage
west: the Storage Room

* * *

>n
Guard Room
A dark wooden table is in the middle of the room, a guard is sitting behind it, half-asleep. There is a small key on the table.

You can see a friends cage door, a metal key and a circus guard here.

>use mirror
The guard squints at the reflection, unfazed.

>look
Guard Room
A dark wooden table is in the middle of the room, a guard is sitting behind it, half-asleep. There is a small key on the table.

You can see a friends cage door, a metal key and a circus guard here.

south: the Hallway
east: the Friend's Cage

>throw ball
Dropped.

>take ball
Taken.

>throwing ball
That's not a verb I recognise.

>throw ball
Dropped.

* * *

>e
Performance Stage
The sandlike ground is littered with objects left behind by the audience. The stage is big enough to do a dance, you can even do a flip!

Some peanut shells and a small pile of peanuts are scattered around.

You can also see an apple and a banana here.

>n
Hallway
A narrow hallway stretches through the circus, dust and dirt covering the floor.

You see something round in the middle of the hallway.

>look
Hallway
A narrow hallway stretches through the circus, dust and dirt covering the floor.

You see something round in the middle of the hallway.

north: the Guard Room
south: the Performance Stage
east: the Old Cage
west: the Storage Room

>take ball
You pick it up-it's a ball.

>w
Storage Room
Old costumes and props surround you everywhere.

Something reflective catches your eye among the props.

>take mirror
It's a small mirror.

>look
Storage Room
Old costumes and props surround you everywhere.

east: the Hallway

* * *

>take key
You snatch the key and quickly hide under the table.

>use mirror
Light flashes down the hallway. The guard storms after it.

>look
Guard Room
A dark wooden table is in the middle of the room, a guard is sitting behind it, half-asleep. There is a small key on the table.

You can see a friends cage door here.

south: the Hallway
east: the Friend's Cage

>e
(first opening the friends cage door)
It seems to be locked.

>look
Guard Room
A dark wooden table is in the middle of the room, a guard is sitting behind it, half-asleep. There is a small key on the table.

You can see a friends cage door here.

south: the Hallway
east: the Friend's Cage

>use key
You use the key. The lock clicks open.

>e
Friend's Cage
Your friend looks at you approaching, he smiles knowing you came to save him.

Something long and rusty lies near the bars.

You can also see a friends cage door and a sewer grate here.

>take bar
You pick it up-it's a rusty crowbar.

>look
Friend's Cage
Your friend looks at you approaching, he smiles knowing you came to save him.

You can see a friend, a friends cage door and a sewer grate here.

north: the Sewer Entrance
west: the Guard Room

>n
The grate blocks the way. Maybe you can pry it open with something.

>UNDO
Friend's Cage
[Previous turn undone.]

>look
Friend's Cage
Your friend looks at you approaching, he smiles knowing you came to save him.

You can see a friend, a friends cage door and a sewer grate here.

north: the Sewer Entrance
west: the Guard Room

* * *

>n
The grate blocks the way. Maybe you can pry it open with something.

>use crowbar
Together you move the grate with a loud screech.

>look
Friend's Cage
Your friend looks at you approaching, he smiles knowing you came to save him.

You can see a friend, a friends cage door and a sewer grate here.

north: the Sewer Entrance
west: the Guard Room

>n
You and your friend climb out through the tunnel and escape into the night!

    *** You escaped! ***

Would you like to RESTART, RESTORE a saved game, QUIT or UNDO the last command?

* * *

>n
Hallway
A narrow hallway stretches through the circus, dust and dirt covering the floor.

You see something round in the middle of the hallway.

>take ball
You pick it up-it's a ball.

>look
Hallway
A narrow hallway stretches through the circus, dust and dirt covering the floor.

north: the Guard Room
south: the Performance Stage
east: the Old Cage
west: the Storage Room

* * *

>e
Hallway
A narrow hallway stretches through the circus, dust and dirt covering the floor.

>n
Guard Room
A dark wooden table is in the middle of the room, a guard is sitting behind it, half-asleep. There is a small key on the table.

You can see a friends cage door, a metal key and a circus guard here.

* * *

>throw ball
The ball hits the wall with a loud thud. The guard stands up to investigate.

>n
You can't go that way.

>take key
You snatch the key and quickly hide under the table.

>n
You can't go that way.

>look
Guard Room
A dark wooden table is in the middle of the room, a guard is sitting behind it, half-asleep. There is a small key on the table.

You can see a friends cage door and a circus guard here.

south: the Hallway
east: the Friend's Cage

>s
The guard catches you immediately. Everything darkens...

Capybara Cage
The bars are old but sturdy, in the distance you see light, it's the exit to the performance stage.

east: the Performance Stage

>i
You are carrying:
  a small mirror

>n
You can't go that way.

>e
Performance Stage
The sandlike ground is littered with objects left behind by the audience.

Some peanut shells and a small pile of peanuts are scattered around.

You can also see an apple and a banana here.

>n
Hallway
A narrow hallway stretches through the circus, dust and dirt covering the floor.

You can see a ball here.

>take ball
Taken.

>n
Guard Room
A dark wooden table is in the middle of the room, a guard is sitting behind it, half-asleep. There is a small key on the table.

You can see a circus guard, a metal key and a friends cage door here.

>throw ball
The ball hits the wall with a loud thud. The guard stands up to investigate.

* * *

>take key
You snatch the key and quickly hide under the table.

>i
You are carrying:
  a metal key
  a ball
  a small mirror

>use mirror
Light flashes down the hallway. The guard storms after it.

* * *

>e
(first opening the friends cage door)
It seems to be locked.

>use key
You're not sure how to use that here.

>look
Guard Room
A dark wooden table is in the middle of the room, a guard is sitting behind it, half-asleep. There is a small key on the table.

You can see a friends cage door here.

south: the Hallway
east: the Friend's Cage

* * *

>e
(first opening the friends cage door)
It seems to be locked.

>e
(first opening the friends cage door)
It seems to be locked.

>unlock key
What do you want to unlock the metal key with?

>unlock door with key
The lock clicks open.

>look
Guard Room
A dark wooden table is in the middle of the room, a guard is sitting behind it, half-asleep. There is a small key on the table.

You can see a friend and a friends cage door here.

south: the Hallway
east: the Friend's Cage

>e
(first opening the friends cage door)

Friend's Cage
Your friend looks at you approaching, he smiles knowing you came to save him.

Something long and rusty lies near the bars.

You can also see a friends cage door and a sewer grate here.

>take bar
You pick it up-it's a rusty crowbar.

* * *

>look
Friend's Cage
Your friend looks at you approaching, he smiles knowing you came to save him.

You can see a friend, a friends cage door and a sewer grate here.

north: the Sewer Entrance
west: the Guard Room

>n
(first opening the sewer grate)
Together you move the grate with a loud screech.

Sewer Entrance
A heavy metal grate is blocking a dark tunnel that goes way beneath the circus.

You can see a sewer grate here.

>open grate
Together you move the grate with a loud screech.

* * *

>e
(first opening the friends cage door)
It seems to be locked.

>use key
You use the key. The lock clicks open.

* * *

>e
Friend's Cage
Your friend looks at you approaching, he smiles knowing you came to save him.

Something long and rusty lies near the bars.

You can also see a friends cage door and a sewer grate here.

>look
Friend's Cage
Your friend looks at you approaching, he smiles knowing you came to save him.

Something long and rusty lies near the bars.

You can also see a friend, a friends cage door and a sewer grate here.

north: the Sewer Entrance
west: the Guard Room

>n
(first opening the sewer grate)
The grate won't budge.

>open grate
The grate won't budge.

>look
Friend's Cage
Your friend looks at you approaching, he smiles knowing you came to save him.

Something long and rusty lies near the bars.

You can also see a friend, a friends cage door and a sewer grate here.

north: the Sewer Entrance
west: the Guard Room

>take bar
You pick it up-it's a rusty crowbar.

* * *

>look
Friend's Cage
Your friend looks at you approaching, he smiles knowing you came to save him.

You can see a friend, a friends cage door and a sewer grate here.

north: the Sewer Entrance
west: the Guard Room

>n
(first opening the sewer grate)
With a final screech, the grate gives way. An escape route!

    *** You escaped! ***

Would you like to RESTART, RESTORE a saved game, QUIT or UNDO the last command?

>open grate
Please give one of the answers above.

Would you like to RESTART, RESTORE a saved game, QUIT or UNDO the last command?

>i
Please give one of the answers above.

Would you like to RESTART, RESTORE a saved game, QUIT or UNDO the last command?

>look
Please give one of the answers above.

Would you like to RESTART, RESTORE a saved game, QUIT or UNDO the last command?

>s
Please give one of the answers above.

Would you like to RESTART, RESTORE a saved game, QUIT or UNDO the last command?

* * *

>n
Hallway
A narrow hallway stretches through the circus, dust and dirt covering the floor.

You see something round in the middle of the hallway.

>take something round
You pick it up-it's a ball.

>i
You are carrying:
  a ball

* * *

>e
Performance Stage
The sandlike ground is littered with objects left behind by the audience. The stage is big enough to do a dance, you can even do a flip!

Some peanut shells and a small pile of peanuts are scattered around.

You can also see an apple and a banana here.

>take apple
You pick up a shiny red apple.

Good thing you can store it in your inventory.

>take banana
You pick up a ripe banana.

>take peanuts
You scoop up the peanuts.

Taken.

* * *

>e
Old Cage
A small dark cage, there is a old capybara watching you.

You can see an old capybara here.

>combine apple and banana
You carefully tie the banana and apple together into a food bundle.

>give capybara food buncle
I only understood you as far as wanting to give the old capybara the food bundle.

>give capybara food bundle
"Ahh... delicious, this takes me back," she whispers. "The key you seek lies on the guard's table. He will only stand if something distracts him."

* * *

>take key
You snatch the key and quickly hide under the table.

>look
Guard Room
A dark wooden table is in the middle of the room, a guard is sitting behind it, half-asleep. There is a small key on the table.

You can see a friends cage door and a circus guard here.

south: the Hallway
east: the Friend's Cage

>s
The guard notices you. Everything darkens...

Capybara Cage
The bars are old but sturdy, in the distance you see light, it's the exit to the performance stage.

east: the Performance Stage

>i
You are carrying:
  a metal key
  a ball
  some peanuts

>look
Capybara Cage
The bars are old but sturdy, in the distance you see light, it's the exit to the performance stage.

east: the Performance Stage

* * *

>n
Hallway
A narrow hallway stretches through the circus, dust and dirt covering the floor.

>look
Hallway
A narrow hallway stretches through the circus, dust and dirt covering the floor.

north: the Guard Room
south: the Performance Stage
east: the Old Cage
west: the Storage Room

>n
Guard Room
A dark wooden table is in the middle of the room, a guard is sitting behind it, half-asleep. There is a small key on the table.

You can see a friends cage door and a circus guard here.

>take key
You snatch the key and quickly hide under the table.

* * *

>e
Performance Stage
The sandlike ground is littered with objects left behind by the audience. The stage is big enough to do a dance, you can even do a flip!

Some peanut shells and a small pile of peanuts are scattered around.

You can also see an apple and a banana here.

>take banana
You pick up a ripe banana.

Good thing you can store it in your inventory.

>take aple
You can't see any such thing.

>take apple
You pick up a shiny red apple.

>take peanuts
You scoop up the peanuts.

* * *

>take apple
You pick up a shiny red apple.

>i
You are carrying:
  an apple
  a banana

>take peanuts
You scoop up the peanuts.

Taken.

* * *

>look
Hallway
A narrow hallway stretches through the circus, dust and dirt covering the floor.

You see something round in the middle of the hallway.

north: the Guard Room
south: the Performance Stage
east: the Old Cage
west: the Storage Room

>w
Storage Room
Old costumes and props surround you everywhere.

Something reflective catches your eye among the props.

* * *

>look
Storage Room
Old costumes and props surround you everywhere.

east: the Hallway

>e
Hallway
A narrow hallway stretches through the circus, dust and dirt covering the floor.

You see something round in the middle of the hallway.

>look
Hallway
A narrow hallway stretches through the circus, dust and dirt covering the floor.

You see something round in the middle of the hallway.

north: the Guard Room
south: the Performance Stage
east: the Old Cage
west: the Storage Room

>take bal
You can't see any such thing.

>take ball
You pick it up-it's a ball.

* * *

>take key
You snatch the key and quickly hide under the table.

>use mirror
Light flashes down the hallway.The guard storms after it.

>look
Guard Room
A dark wooden table is in the middle of the room, a guard is sitting behind it, half-asleep. There is a small key on the table.

You can see a friends cage door here.

south: the Hallway
east: the Friend's Cage

>e
The guard catches you immediately. Everything darkens...

Capybara Cage
The bars are old but sturdy, in the distance you see light, it's the exit to the performance stage.

east: the Performance Stage

* * *

>take peanuts
You scoop up the peanuts.

Taken.

>i
You are carrying:
  some peanuts
  an apple
  a banana

>e
You can't go that way.

>w
Capybara Cage
The bars are old but sturdy, in the distance you see light, it's the exit to the performance stage.

* * *

>e
Performance Stage
The sandlike ground is littered with objects left behind by the audience.

>n
Hallway
A narrow hallway stretches through the circus, dust and dirt covering the floor.

You see something round in the middle of the hallway.

* * *

>take something round
You pick it up-it's a ball.

>n
Guard Room
A dark wooden table is in the middle of the room, a guard is sitting behind it, half-asleep. There is a small key on the table.

You can see a friends cage door, a metal key and a circus guard here.

>n
You can't go that way.

>take key
The guard catches you immediately. Everything darkens...

Capybara Cage
The bars are old but sturdy, in the distance you see light, it's the exit to the performance stage.

>i
You are carrying:
  a ball
  some peanuts
  an apple
  a banana

>n
You can't go that way.

>e
Performance Stage
The sandlike ground is littered with objects left behind by the audience.

* * *

>n
Hallway
A narrow hallway stretches through the circus, dust and dirt covering the floor.

>n
Guard Room
A dark wooden table is in the middle of the room, a guard is sitting behind it, half-asleep. There is a small key on the table.

You can see a friends cage door, a metal key and a circus guard here.

>s
Hallway
A narrow hallway stretches through the circus, dust and dirt covering the floor.

>w
Storage Room
Old costumes and props surround you everywhere.

Something reflective catches your eye among the props.

>take something reflective
You can't see any such thing.

* * *

>n
Hallway
A narrow hallway stretches through the circus, dust and dirt covering the floor.

You see something round in the middle of the hallway.

>combine apple and banana
You carefully tie the banana and apple together into a food bundle.

>look
Hallway
A narrow hallway stretches through the circus, dust and dirt covering the floor.

You see something round in the middle of the hallway.

north: the Guard Room
south: the Performance Stage
east: the Old Cage
west: the Storage Room

>take round object
You pick it up-it's a ball.

>i
You are carrying:
  a ball
  a food bundle
  some peanuts

>look
Hallway
A narrow hallway stretches through the circus, dust and dirt covering the floor.

north: the Guard Room
south: the Performance Stage
east: the Old Cage
west: the Storage Room

* * *

>ask capybara about key
"No, no," she says. "That won't help me remember."

>give capybara food bundle
"Ahh... delicious, this takes me back," she whispers. "The key you seek lies on the guard's table. He will only stand if something distracts him."

* * *

>n
Guard Room
A dark wooden table is in the middle of the room, a guard is sitting behind it, half-asleep. There is a small key on the table.

You can see a friends cage door, a metal key and a circus guard here.

>look
Guard Room
A dark wooden table is in the middle of the room, a guard is sitting behind it, half-asleep. There is a small key on the table.

You can see a friends cage door, a metal key and a circus guard here.

south: the Hallway
east: the Friend's Cage

>s
Hallway
A narrow hallway stretches through the circus, dust and dirt covering the floor.

>look
Hallway
A narrow hallway stretches through the circus, dust and dirt covering the floor.

north: the Guard Room
south: the Performance Stage
east: the Old Cage
west: the Storage Room

* * *

>use mirror
The guard squints at the reflection, unfazed.

>throw ball
The ball hits the wall with a loud thud. The guard stands up to investigate.

* * *

>look
Guard Room
A dark wooden table is in the middle of the room, a guard is sitting behind it, half-asleep. There is a small key on the table.

You can see a friends cage door and a circus guard here.

south: the Hallway
east: the Friend's Cage

>s
Hallway
A narrow hallway stretches through the circus, dust and dirt covering the floor.

* * *

>n
Guard Room
A dark wooden table is in the middle of the room, a guard is sitting behind it, half-asleep. There is a small key on the table.

You can see a friends cage door and a circus guard here.

>key
That's not a verb I recognise.

>take key
You snatch the key and quickly hide under the table.

* * *

>look
Hallway
A narrow hallway stretches through the circus, dust and dirt covering the floor.

You see something round in the middle of the hallway.

north: the Guard Room
south: the Performance Stage
east: the Old Cage
west: the Storage Room

>e
Old Cage
A small dark cage, there is a old capybara watching you.

You can see an old capybara here.

>combine banana and apple
You carefully tie the banana and apple together into a food bundle.

>give capybara food bundle
"Ahh... delicious, this takes me back," she whispers. "The key you seek lies on the guard's table. He will only stand if something distracts him."

* * *

>look
Old Cage
A small dark cage, there is a old capybara watching you.

You can see an old capybara here.

west: the Hallway

>w
Hallway
A narrow hallway stretches through the circus, dust and dirt covering the floor.

You see something round in the middle of the hallway.

>take round objec
You can't see any such thing.

* * *

>e
The guard catches you immediately. Everything darkens...

Capybara Cage
The bars are old but sturdy, in the distance you see light, it's the exit to the performance stage.

east: the Performance Stage

>i
You are carrying:
  some peanuts

>n
You can't go that way.

* * *

>e
Performance Stage
The sandlike ground is littered with objects left behind by the audience.

>n
Hallway
A narrow hallway stretches through the circus, dust and dirt covering the floor.

You can see a ball here.

* * *

>take ball
Taken.

>look
Hallway
A narrow hallway stretches through the circus, dust and dirt covering the floor.

north: the Guard Room
south: the Performance Stage
east: the Old Cage
west: the Storage Room

>n
Guard Room
A dark wooden table is in the middle of the room, a guard is sitting behind it, half-asleep. There is a small key on the table.

You can see a circus guard, a metal key and a friends cage door here.

>take key
The guard catches you immediately. Everything darkens...

Capybara Cage
The bars are old but sturdy, in the distance you see light, it's the exit to the performance stage.

east: the Performance Stage

>e
Performance Stage
The sandlike ground is littered with objects left behind by the audience.

* * *

>n
Hallway
A narrow hallway stretches through the circus, dust and dirt covering the floor.

>i
You are carrying:
  a ball
  some peanuts

>n
Guard Room
A dark wooden table is in the middle of the room, a guard is sitting behind it, half-asleep. There is a small key on the table.

You can see a circus guard, a metal key and a friends cage door here.

>look
Guard Room
A dark wooden table is in the middle of the room, a guard is sitting behind it, half-asleep. There is a small key on the table.

You can see a circus guard, a metal key and a friends cage door here.

south: the Hallway
east: the Friend's Cage

>s
The guard catches you immediately. Everything darkens...

Capybara Cage
The bars are old but sturdy, in the distance you see light, it's the exit to the performance stage.

east: the Performance Stage

>look
Capybara Cage
The bars are old but sturdy, in the distance you see light, it's the exit to the performance stage.

east: the Performance Stage

* * *

>n
Hallway
A narrow hallway stretches through the circus, dust and dirt covering the floor.

You can see a ball here.

>look
Hallway
A narrow hallway stretches through the circus, dust and dirt covering the floor.

You can see a ball here.

north: the Guard Room
south: the Performance Stage
east: the Old Cage
west: the Storage Room

>w
Storage Room
Old costumes and props surround you everywhere.

Something reflective catches your eye among the props.

* * *

>look
Storage Room
Old costumes and props surround you everywhere.

east: the Hallway

>e
Hallway
A narrow hallway stretches through the circus, dust and dirt covering the floor.

You can see a ball here.

>n
Guard Room
A dark wooden table is in the middle of the room, a guard is sitting behind it, half-asleep. There is a small key on the table.

You can see a circus guard, a metal key and a friends cage door here.

>use mirror
The guard squints at the reflection, unfazed.

>throw ball
You can't see any such thing.

>take key
The guard catches you immediately. Everything darkens...

Capybara Cage
The bars are old but sturdy, in the distance you see light, it's the exit to the performance stage.

east: the Performance Stage

>look
Capybara Cage
The bars are old but sturdy, in the distance you see light, it's the exit to the performance stage.

east: the Performance Stage

* * *

>take ball
Taken.

>i
You are carrying:
  a ball
  a small mirror
  some peanuts

>n
Guard Room
A dark wooden table is in the middle of the room, a guard is sitting behind it, half-asleep. There is a small key on the table.

You can see a circus guard, a metal key and a friends cage door here.

* * *

>take key
You snatch the key and quickly hide under the table.

>use mirror
Light flashes down the hallway. The guard storms after it.

*** Run-time problem P61: Attempt to move the player off-stage.

* * *

>take peanuts
You scoop up the peanuts.

Taken.

>n
Hallway
A narrow hallway stretches through the circus, dust and dirt covering the floor.

You see something round in the middle of the hallway.

>look around
You can't see any such thing.

>exits
That's not a verb I recognise.

>exit
But you aren't in anything at the moment.

I beg your pardon?

>take round object
You pick it up-it's a ball.

* * *

You wake up in a cold room, the floor is stone and you are surrounded by metal bars, it's a cage. Somewhere inside is your friend, you know you have to find him as soon as possible and escape.

Capybara Escape
An Interactive Fiction by Petra
Release 1 / Serial number 260118 / Inform 7 v10.1.2 / D

Capybara Cage
The bars are old but sturdy, in the distance you see light, it's the exit to the performance stage.

>go n
You can't go that way.

>n
You can't go that way.

>go e
Performance Stage
The sandlike ground is littered with objects left behind by the audience. Peanut shells, banana peels and apple cores all around you.

>n
Hallway
A narrow hallway stretches through the circus, dust and dirt covering the floor.

>e
You can't go that way.

>w
You can't go that way.

* * *

You wake up in a cold room, the floor is stone and you are surrounded by metal bars, it's a cage. Somewhere inside is your friend, you know you have to find him as soon as possible and escape.

Capybara Escape
An Interactive Fiction by Petra
Release 1 / Serial number 260118 / Inform 7 v10.1.2 / D

Capybara Cage
The bars are old but sturdy, in the distance you see light, it's the exit to the performance stage.

>l
Capybara Cage
The bars are old but sturdy, in the distance you see light, it's the exit to the performance stage.

east: the Performance Stage

>e
Performance Stage
The sandlike ground is littered with objects left behind by the audience. The stage is big enough to do a dance, you can even do a flip!

Some peanut shells and a small pile of peanuts are scattered around.

You can also see an apple and a banana here.

>l
Performance Stage
The sandlike ground is littered with objects left behind by the audience. The stage is big enough to do a dance, you can even do a flip!

Some peanut shells and a small pile of peanuts are scattered around.

You can also see an apple and a banana here.

north: the Hallway
west: the Capybara Cage

>take peanuts
You scoop up the peanuts.

Good thing you can store it in your inventory.

>take apple
You pick up a shiny red apple.

>take banana
You pick up a ripe banana.

>eat banana
You eat the banana. It was filling but maybe you shouldn't have :(

>l
Performance Stage
The sandlike ground is littered with objects left behind by the audience. The stage is big enough to do a dance, you can even do a flip!

You can see a banana here.

north: the Hallway
west: the Capybara Cage

* * *

>l
Performance Stage
The sandlike ground is littered with objects left behind by the audience. The stage is big enough to do a dance, you can even do a flip!

north: the Hallway
west: the Capybara Cage

>i
You are carrying:
  a banana
  an apple
  some peanuts

>eat banana
You eat the banana. It was filling but maybe you shouldn't have :(

>i
You are carrying:
  an apple
  some peanuts

>l
Performance Stage
The sandlike ground is littered with objects left behind by the audience. The stage is big enough to do a dance, you can even do a flip!

You can see a banana here.

north: the Hallway
west: the Capybara Cage

* * *

>eat banana
You eat the banana. It was filling but maybe you shouldn't have :(

* * *

>l
Performance Stage
The sandlike ground is littered with objects left behind by the audience. The stage is big enough to do a dance, you can even do a flip!

north: the Hallway
west: the Capybara Cage

>n
Hallway
A narrow hallway stretches through the circus, dust and dirt covering the floor.

You see something round in the middle of the hallway.

>l
Hallway
A narrow hallway stretches through the circus, dust and dirt covering the floor.

You see something round in the middle of the hallway.

north: the Guard Room
south: the Performance Stage
east: the Old Cage
west: the Storage Room

>take ball
You pick it up-it's a ball.

>e
Old Cage
A small dark cage, there is a old capybara watching you.

You can see an old capybara here.

>l
Old Cage
A small dark cage, there is a old capybara watching you.

You can see an old capybara here.

west: the Hallway

>ask about guard
You can't see any such thing.

>ask capybara about guard
"No, no," she says. "That won't help me remember. But a food bundle combined of two fruits might help ;)"

>i
You are carrying:
  a ball
  a banana
  an apple
  some peanuts

>combine peanuts and apple
I didn't understand that sentence.

>combine ball and peanuts
I didn't understand that sentence.

>combine banana and apple
You carefully tie the banana and apple together into a food bundle.

>i
You are carrying:
  a food bundle
  a ball
  some peanuts

>give food bundle to capybara
"Ahh... delicious, this takes me back," she whispers. "The key you seek lies on the guard's table. He will only stand up and move from the table if something distracts him."

>ask capybara what can distract guard
I didn't understand that sentence.

>l
Old Cage
A small dark cage, there is a old capybara watching you.

You can see an old capybara here.

west: the Hallway

>w
Hallway
A narrow hallway stretches through the circus, dust and dirt covering the floor.

>l
Hallway
A narrow hallway stretches through the circus, dust and dirt covering the floor.

north: the Guard Room
south: the Performance Stage
east: the Old Cage
west: the Storage Room

>w
Storage Room
Old costumes and props surround you everywhere.

Something reflective catches your eye among the props.

>l
Storage Room
Old costumes and props surround you everywhere.

Something reflective catches your eye among the props.

east: the Hallway

>take mirror
It's a small mirror.

>l
Storage Room
Old costumes and props surround you everywhere.

east: the Hallway

>e
Hallway
A narrow hallway stretches through the circus, dust and dirt covering the floor.

>l
Hallway
A narrow hallway stretches through the circus, dust and dirt covering the floor.

north: the Guard Room
south: the Performance Stage
east: the Old Cage
west: the Storage Room

>s
Performance Stage
The sandlike ground is littered with objects left behind by the audience. The stage is big enough to do a dance, you can even do a flip!

>do a flip
You do a flip. Nailed it!!

>l
Performance Stage
The sandlike ground is littered with objects left behind by the audience. The stage is big enough to do a dance, you can even do a flip!

north: the Hallway
west: the Capybara Cage

>n
Hallway
A narrow hallway stretches through the circus, dust and dirt covering the floor.

>do a flip
There's not enough space to do a flip here.

>l
Hallway
A narrow hallway stretches through the circus, dust and dirt covering the floor.

north: the Guard Room
south: the Performance Stage
east: the Old Cage
west: the Storage Room

>dance
This doesn't feel like the right place to dance.

>s
Performance Stage
The sandlike ground is littered with objects left behind by the audience. The stage is big enough to do a dance, you can even do a flip!

>dance
You dance to imaginary circus music and you slay!!!

>l
Performance Stage
The sandlike ground is littered with objects left behind by the audience. The stage is big enough to do a dance, you can even do a flip!

north: the Hallway
west: the Capybara Cage

* * *

>n
Guard Room
A dark wooden table is in the middle of the room, a guard is sitting behind it, half-asleep. There is a small key on the table.

You can see a friends cage door, a metal key and a circus guard here.

>l
Guard Room
A dark wooden table is in the middle of the room, a guard is sitting behind it, half-asleep. There is a small key on the table.

You can see a friends cage door, a metal key and a circus guard here.

south: the Hallway
east: the Friend's Cage

>use mirror
The guard squints at the reflection, unfazed.

>l
Guard Room
A dark wooden table is in the middle of the room, a guard is sitting behind it, half-asleep. There is a small key on the table.

You can see a friends cage door, a metal key and a circus guard here.

south: the Hallway
east: the Friend's Cage

>i
You are carrying:
  a small mirror
  a ball
  some peanuts

>throw peanuts
Dropped.

>l
Guard Room
A dark wooden table is in the middle of the room, a guard is sitting behind it, half-asleep. There is a small key on the table.

You can see some peanuts, a friends cage door, a metal key and a circus guard here.

south: the Hallway
east: the Friend's Cage

>i
You are carrying:
  a small mirror
  a ball

>take peanuts
Taken.

>eat peanuts
You munch on the peanuts. Tastyy!

>l
Guard Room
A dark wooden table is in the middle of the room, a guard is sitting behind it, half-asleep. There is a small key on the table.

You can see a friends cage door, a metal key and a circus guard here.

south: the Hallway
east: the Friend's Cage

>i
You are carrying:
  a small mirror
  a ball

>use ball
You're not sure how to use that here.

>throw ball
The ball hits the wall with a loud thud. The guard stands up from his table to investigate. He moves away from the table towards the wall.

>take key
You snatch the key and quickly hide under the table.

>l
Guard Room
A dark wooden table is in the middle of the room, a guard is sitting behind it, half-asleep. There is a small key on the table.

You can see a friends cage door and a circus guard here.

south: the Hallway
east: the Friend's Cage

>s
The guard catches you immediately. Everything darkens...

Capybara Cage
The bars are old but sturdy, in the distance you see light, it's the exit to the performance stage.

east: the Performance Stage

>l
Capybara Cage
The bars are old but sturdy, in the distance you see light, it's the exit to the performance stage.

east: the Performance Stage

>i
You are carrying:
  a small mirror

* * *

>n
You can't go that way.

>n
You can't go that way.

>w
You can't go that way.

>e
Performance Stage
The sandlike ground is littered with objects left behind by the audience. The stage is big enough to do a dance, you can even do a flip!

>n
Hallway
A narrow hallway stretches through the circus, dust and dirt covering the floor.

You can see a ball here.

>n
Guard Room
A dark wooden table is in the middle of the room, a guard is sitting behind it, half-asleep. There is a small key on the table.

You can see a circus guard, a metal key and a friends cage door here.

>i
You are carrying:
  a small mirror

* * *

>n
You can't go that way.

>l
Guard Room
A dark wooden table is in the middle of the room, a guard is sitting behind it, half-asleep. There is a small key on the table.

You can see a circus guard, a metal key and a friends cage door here.

south: the Hallway
east: the Friend's Cage

>s
The guard catches you immediately. Everything darkens...

Capybara Cage
The bars are old but sturdy, in the distance you see light, it's the exit to the performance stage.

east: the Performance Stage

* * *

>l
Capybara Cage
The bars are old but sturdy, in the distance you see light, it's the exit to the performance stage.

east: the Performance Stage

>e
Performance Stage
The sandlike ground is littered with objects left behind by the audience. The stage is big enough to do a dance, you can even do a flip!

>l
Performance Stage
The sandlike ground is littered with objects left behind by the audience. The stage is big enough to do a dance, you can even do a flip!

north: the Hallway
west: the Capybara Cage

>n
Hallway
A narrow hallway stretches through the circus, dust and dirt covering the floor.

You can see a ball here.

* * *

>n
Guard Room
A dark wooden table is in the middle of the room, a guard is sitting behind it, half-asleep. There is a small key on the table.

You can see a circus guard, a metal key and a friends cage door here.

>l
Guard Room
A dark wooden table is in the middle of the room, a guard is sitting behind it, half-asleep. There is a small key on the table.

You can see a circus guard, a metal key and a friends cage door here.

south: the Hallway
east: the Friend's Cage

>throw ball
The ball hits the wall with a loud thud. The guard stands up from his table to investigate. He moves away from the table towards the wall.

* * *

>use mirror
Light flashes down the hallway. The guard storms after it.

>l
Guard Room
A dark wooden table is in the middle of the room, a guard is sitting behind it, half-asleep. There is a small key on the table.

You can see a friends cage door here.

south: the Hallway
east: the Friend's Cage

>e
It seems to be locked.

>use key
You use the key. The lock clicks open.

* * *

>e
Friend's Cage
Your friend looks at you approaching, he smiles knowing you came to save him.

Something long and rusty lies near the bars.

You can also see a friends cage door and a sewer grate here.

>take something long and rusty
You pick it up-it's a rusty crowbar.

>l
Friend's Cage
Your friend looks at you approaching, he smiles knowing you came to save him.

You can see a friend, a friends cage door and a sewer grate here.

north: the Sewer Entrance
west: the Guard Room

>n
The grate blocks the way. Maybe you can pry it open with something.

>take something long and rusty
You already have that.

>l
Friend's Cage
Your friend looks at you approaching, he smiles knowing you came to save him.

You can see a friend, a friends cage door and a sewer grate here.

north: the Sewer Entrance
west: the Guard Room

* * *

>n
The grate blocks the way. Maybe you can pry it open with something.

>l
Friend's Cage
Your friend looks at you approaching, he smiles knowing you came to save him.

You can see a friend, a friends cage door and a sewer grate here.

north: the Sewer Entrance
west: the Guard Room

>l
Friend's Cage
Your friend looks at you approaching, he smiles knowing you came to save him.

You can see a friend, a friends cage door and a sewer grate here.

north: the Sewer Entrance
west: the Guard Room

>take something long and rusty
You already have that.

>i
You are carrying:
  a rusty crowbar
  a metal key
  a ball
  a small mirror

>pry open with crowbar
That's not a verb I recognise.

>pry open grate
That's not a verb I recognise.

>n
The grate blocks the way. Maybe you can pry it open with something.

* * *

>use crowbar
Together you move the grate with a loud screech.

>l
Friend's Cage
Your friend looks at you approaching, he smiles knowing you came to save him.

You can see a friend, a friends cage door and a sewer grate here.

north: the Sewer Entrance
west: the Guard Room

>n
You and your friend climb out through the tunnel and escape into the night!

    *** You escaped! ***

Would you like to RESTART, RESTORE a saved game, QUIT or UNDO the last command?

* * *

You wake up in a cold room, the floor is stone and you are surrounded by metal bars, it's a cage. Somewhere inside is your friend, you know you have to find him as soon as possible and escape.

Capybara Escape
An Interactive Fiction by Petra
Release 1 / Serial number 260118 / Inform 7 v10.1.2 / D

Capybara Cage
The bars are old but sturdy, in the distance you see light, it's the exit to the performance stage.

>look
Capybara Cage
The bars are old but sturdy, in the distance you see light, it's the exit to the performance stage.

east: the Performance Stage

I beg your pardon?

>e
Performance Stage
The sandlike ground is littered with objects left behind by the audience.

Some peanut shells and a small pile of peanuts are scattered around.

You can also see an apple and a banana here.

>take banana
You pick up a ripe banana.

Good thing you can store it in your inventory.

>take apple
You pick up a shiny red apple.

Taken.

I beg your pardon?

>take peanuts
You scoop up the peanuts.

Taken.

* * *

>take reflective object
It's a small mirror.

>i
You are carrying:
  a small mirror
  a ball
  some peanuts
  an apple
  a banana

>eat banana
You eat the banana. It was filling but maybe you shouldn't have :(

>look
Storage Room
Old costumes and props surround you everywhere.

east: the Hallway

* * *

>look
Hallway
A narrow hallway stretches through the circus, dust and dirt covering the floor.

north: the Guard Room
south: the Performance Stage
east: the Old Cage
west: the Storage Room

I beg your pardon?

>e
Old Cage
A small dark cage, there is a old capybara watching you.

You can see an old capybara here.

* * *

>ask capybara about key
"No, no," she says. "That won't help me remember."

>combine banana and apple
You already ate part of the food. There isn't enough left to make a food bundle.

>look
Old Cage
A small dark cage, there is a old capybara watching you.

You can see an old capybara here.

west: the Hallway

* * *

>look
Hallway
A narrow hallway stretches through the circus, dust and dirt covering the floor.

north: the Guard Room
south: the Performance Stage
east: the Old Cage
west: the Storage Room

>s
Performance Stage
The sandlike ground is littered with objects left behind by the audience.

You can see a banana here.

>take banana
Taken.

>look
Performance Stage
The sandlike ground is littered with objects left behind by the audience.

north: the Hallway
west: the Capybara Cage

>n
Hallway
A narrow hallway stretches through the circus, dust and dirt covering the floor.

* * *

>e
Old Cage
A small dark cage, there is a old capybara watching you.

You can see an old capybara here.

>combine banana and apple
You already ate part of the food. There isn't enough left to make a food bundle.

>i
You are carrying:
  a banana
  a small mirror
  a ball
  some peanuts
  an apple

>combine a banana and a apple
I didn't understand that sentence.

>combine apple and banana
You already ate part of the food. There isn't enough left to make a food bundle.

* * *

>look
Capybara Cage
The bars are old but sturdy, in the distance you see light, it's the exit to the performance stage.

east: the Performance Stage

>e
Performance Stage
The sandlike ground is littered with objects left behind by the audience. The stage is big enough to do a dance, you can even do a flip!

Some peanut shells and a small pile of peanuts are scattered around.

You can also see an apple and a banana here.

* * *

>take apple
You pick up a shiny red apple.

>combine banana and apple
You carefully tie the banana and apple together into a food bundle.

>eat food bundle
That's plainly inedible.

* * *

>e
Performance Stage
The sandlike ground is littered with objects left behind by the audience. The stage is big enough to do a dance, you can even do a flip!

Some peanut shells and a small pile of peanuts are scattered around.

You can also see an apple and a banana here.

>take peanuts
You scoop up the peanuts.

Good thing you can store it in your inventory.

>take banana
You pick up a ripe banana.

>take apple
You pick up a shiny red apple.

>look
Performance Stage
The sandlike ground is littered with objects left behind by the audience. The stage is big enough to do a dance, you can even do a flip!

north: the Hallway
west: the Capybara Cage

>n
Hallway
A narrow hallway stretches through the circus, dust and dirt covering the floor.

You see something round in the middle of the hallway.

* * *

>take something round
You pick it up-it's a ball.

>look
Hallway
A narrow hallway stretches through the circus, dust and dirt covering the floor.

north: the Guard Room
south: the Performance Stage
east: the Old Cage
west: the Storage Room

* * *

>e
Old Cage
A small dark cage, there is a old capybara watching you.

You can see an old capybara here.

>ask capybara about guard
"No, no," she says. "That won't help me remember. But a food bundle combined of two fruits might help ;)".

>combine banana and apple
You carefully tie the banana and apple together into a food bundle.

>inventory
You are carrying:
  a food bundle
  a ball
  some peanuts

>give capybara food bundle
"Ahh... delicious, this takes me back," she whispers. "The key you seek lies on the circus guard's table. He will only stand up and move from the table if something distracts him."

>look
Old Cage
A small dark cage, there is a old capybara watching you.

You can see an old capybara here.

west: the Hallway

* * *

>look
Hallway
A narrow hallway stretches through the circus, dust and dirt covering the floor.

north: the Guard Room
south: the Performance Stage
east: the Old Cage
west: the Storage Room

>n
Guard Room
A dark wooden table is in the middle of the room, a circus guard is sitting behind it, half-asleep. There is a small key on the table.

You can see a friends cage door, a metal key and a circus guard here.

>look
Guard Room
A dark wooden table is in the middle of the room, a circus guard is sitting behind it, half-asleep. There is a small key on the table.

You can see a friends cage door, a metal key and a circus guard here.

south: the Hallway
east: the Friend's Cage

>e
It seems to be locked.

>throw ball
The ball hits the wall with a loud thud. The circus guard stands up from his table to investigate. He moves away from the table towards the wall.

>take key
You snatch the key and quickly hide under the table.

>look
Guard Room
A dark wooden table is in the middle of the room, a circus guard is sitting behind it, half-asleep. There is a small key on the table.

You can see a friends cage door and a circus guard here.

south: the Hallway
east: the Friend's Cage

>e
It seems to be locked.

>use key
The circus guard catches you immediately. Everything darkens...

Capybara Cage
The bars are old but sturdy, in the distance you see light, it's the exit to the performance stage.

east: the Performance Stage

>e
Performance Stage
The sandlike ground is littered with objects left behind by the audience. The stage is big enough to do a dance, you can even do a flip!

* * *

>w
Storage Room
Old costumes and props surround you everywhere.

Something reflective catches your eye among the props.

>take something reflective
It's a small mirror.

>look
Storage Room
Old costumes and props surround you everywhere.

east: the Hallway

* * *

>look
Hallway
A narrow hallway stretches through the circus, dust and dirt covering the floor.

north: the Guard Room
south: the Performance Stage
east: the Old Cage
west: the Storage Room

>n
Guard Room
A dark wooden table is in the middle of the room, a circus guard is sitting behind it, half-asleep. There is a small key on the table.

You can see a circus guard, a metal key and a friends cage door here.

>throw ball
The ball hits the wall with a loud thud. The circus guard stands up from his table to investigate. He moves away from the table towards the wall.

* * *

>take key
You snatch the key and quickly hide under the table.

>use mirror
Light flashes down the hallway. The circus guard storms after it.

>look
Guard Room
A dark wooden table is in the middle of the room, a circus guard is sitting behind it, half-asleep. There is a small key on the table.

You can see a friends cage door here.

south: the Hallway
east: the Friend's Cage

>e
It seems to be locked.

* * *

>take something long and rusty
You pick it up-it's a rusty crowbar.

>inventory
You are carrying:
  a rusty crowbar
  a metal key
  a small mirror
  a ball
  some peanuts

>look
Friend's Cage
Your friend looks at you approaching, he smiles knowing you came to save him.

You can see a friend, a friends cage door and a sewer grate here.

north: the Sewer Entrance
west: the Guard Room

* * *

>use crowbar
Together you move the grate with a loud screech.

>n
You and your friend climb out through the tunnel and escape into the night!

    *** You escaped! ***

Would you like to RESTART, RESTORE a saved game, QUIT or UNDO the last command?

* * *

>look
Capybara Cage
The bars are old but sturdy, in the distance you see light, it's the exit to the performance stage.

east: the Performance Stage

>east
Performance Stage
The sandlike ground is littered with objects left behind by the audience.

Some peanut shells and a small pile of peanuts are scattered around.

You can also see an apple and a banana here.

>look
Performance Stage
The sandlike ground is littered with objects left behind by the audience.

Some peanut shells and a small pile of peanuts are scattered around.

You can also see an apple and a banana here.

north: the Hallway
west: the Capybara Cage

>go north
Hallway
A narrow hallway stretches through the circus, dust and dirt covering the floor.

You see something round in the middle of the hallway.

>go back
You can't see any such thing.

>look
Hallway
A narrow hallway stretches through the circus, dust and dirt covering the floor.

You see something round in the middle of the hallway.

north: the Guard Room
south: the Performance Stage
east: the Old Cage
west: the Storage Room

>go to the performance stage
You can't see any such thing.

>go south
Performance Stage
The sandlike ground is littered with objects left behind by the audience.

Some peanut shells and a small pile of peanuts are scattered around.

You can also see an apple and a banana here.

>look
Performance Stage
The sandlike ground is littered with objects left behind by the audience.

Some peanut shells and a small pile of peanuts are scattered around.

You can also see an apple and a banana here.

north: the Hallway
west: the Capybara Cage

>take peanuts
You scoop up the peanuts.

Good thing you can store it in your inventory.

* * *

>take banana
You pick up a ripe banana.

>n
Hallway
A narrow hallway stretches through the circus, dust and dirt covering the floor.

You see something round in the middle of the hallway.

* * *

>look
Hallway
A narrow hallway stretches through the circus, dust and dirt covering the floor.

You see something round in the middle of the hallway.

north: the Guard Room
south: the Performance Stage
east: the Old Cage
west: the Storage Room

>take something round
You pick it up-it's a ball.

>e
Old Cage
A small dark cage, there is a old capybara watching you.

You can see an old capybara here.

>look
Old Cage
A small dark cage, there is a old capybara watching you.

You can see an old capybara here.

west: the Hallway

>west
Hallway
A narrow hallway stretches through the circus, dust and dirt covering the floor.

>look
Hallway
A narrow hallway stretches through the circus, dust and dirt covering the floor.

north: the Guard Room
south: the Performance Stage
east: the Old Cage
west: the Storage Room

>s
Performance Stage
The sandlike ground is littered with objects left behind by the audience.

>look
Performance Stage
The sandlike ground is littered with objects left behind by the audience.

north: the Hallway
west: the Capybara Cage

* * *

>w
Capybara Cage
The bars are old but sturdy, in the distance you see light, it's the exit to the performance stage.

>look
Capybara Cage
The bars are old but sturdy, in the distance you see light, it's the exit to the performance stage.

east: the Performance Stage

* * *

>e
Old Cage
A small dark cage, there is a old capybara watching you.

You can see an old capybara here.

>talk to old capybara
That's not a verb I recognise.

>ask old capybara about something
There is no reply.

>look
Old Cage
A small dark cage, there is a old capybara watching you.

You can see an old capybara here.

west: the Hallway

* * *

>take something reflective
It's a small mirror.

>i
You are carrying:
  a small mirror
  a ball
  a banana
  an apple
  some peanuts

>look
Storage Room
Old costumes and props surround you everywhere.

east: the Hallway

* * *

>look
Performance Stage
The sandlike ground is littered with objects left behind by the audience.

north: the Hallway
west: the Capybara Cage

>dance
That's not a verb I recognise.

>look
Performance Stage
The sandlike ground is littered with objects left behind by the audience.

north: the Hallway
west: the Capybara Cage

* * *

>n
Guard Room
A dark wooden table is in the middle of the room, a guard is sitting behind it, half-asleep. There is a small key on the table.

You can see a friends cage door, a metal key and a circus guard here.

>open friends cage door
It seems to be locked.

>take metal key
The guard catches you immediately. Everything darkens...

Capybara Cage
The bars are old but sturdy, in the distance you see light, it's the exit to the performance stage.

east: the Performance Stage

>i
You are carrying:
  a small mirror
  a ball
  a banana
  an apple
  some peanuts

>l
Capybara Cage
The bars are old but sturdy, in the distance you see light, it's the exit to the performance stage.

east: the Performance Stage

>e
Performance Stage
The sandlike ground is littered with objects left behind by the audience.

>l
Performance Stage
The sandlike ground is littered with objects left behind by the audience.

north: the Hallway
west: the Capybara Cage

>n
Hallway
A narrow hallway stretches through the circus, dust and dirt covering the floor.

* * *

>l
Guard Room
A dark wooden table is in the middle of the room, a guard is sitting behind it, half-asleep. There is a small key on the table.

You can see a friends cage door, a metal key and a circus guard here.

south: the Hallway
east: the Friend's Cage

>e
It seems to be locked.

>blind with mirror
That's not a verb I recognise.

>use mirror
The guard squints at the reflection, unfazed.

* * *

>l
Guard Room
A dark wooden table is in the middle of the room, a guard is sitting behind it, half-asleep. There is a small key on the table.

You can see a friends cage door, a metal key and a circus guard here.

south: the Hallway
east: the Friend's Cage

>i
You are carrying:
  a small mirror
  a ball
  a banana
  an apple
  some peanuts

>use mirror
The guard squints at the reflection, unfazed.

>use mirror
The guard squints at the reflection, unfazed.

>use ball
You're not sure how to use that here.

>throw ball
The ball hits the wall with a loud thud. The guard stands up to investigate.

>l
Guard Room
A dark wooden table is in the middle of the room, a guard is sitting behind it, half-asleep. There is a small key on the table.

You can see a friends cage door, a metal key and a circus guard here.

south: the Hallway
east: the Friend's Cage

>s
The guard catches you immediately. Everything darkens...

Capybara Cage
The bars are old but sturdy, in the distance you see light, it's the exit to the performance stage.

east: the Performance Stage

* * *

>l
Performance Stage
The sandlike ground is littered with objects left behind by the audience.

north: the Hallway
west: the Capybara Cage

>l
Performance Stage
The sandlike ground is littered with objects left behind by the audience.

north: the Hallway
west: the Capybara Cage

>n
Hallway
A narrow hallway stretches through the circus, dust and dirt covering the floor.

You can see a ball here.

>l
Hallway
A narrow hallway stretches through the circus, dust and dirt covering the floor.

You can see a ball here.

north: the Guard Room
south: the Performance Stage
east: the Old Cage
west: the Storage Room

>i
You are carrying:
  a small mirror
  a banana
  an apple
  some peanuts

>take ball
Taken.

>l
Hallway
A narrow hallway stretches through the circus, dust and dirt covering the floor.

north: the Guard Room
south: the Performance Stage
east: the Old Cage
west: the Storage Room

>e
Old Cage
A small dark cage, there is a old capybara watching you.

You can see an old capybara here.

* * *

>l
Old Cage
A small dark cage, there is a old capybara watching you.

You can see an old capybara here.

west: the Hallway

>ask capybara about guard
There is no reply.

>ask capybara about key
"No, no," she says. "That won't help me remember."

>ask capybara if she wants to live
I didn't understand that sentence.

>give banana to capybara
"No, no," she says. "That won't help me remember."

>combine banana and apple
You carefully tie the banana and apple together into a food bundle.

>i
You are carrying:
  a food bundle
  a ball
  a small mirror
  some peanuts

>combine peanuts and food bundle
I didn't understand that sentence.

>give food bundle to capybara
"Ahh... delicious, this takes me back," she whispers. "The key you seek lies on the guard's table. He will only stand if something distracts him."

>l
Old Cage
A small dark cage, there is a old capybara watching you.

You can see an old capybara here.

west: the Hallway

* * *

>l
Hallway
A narrow hallway stretches through the circus, dust and dirt covering the floor.

north: the Guard Room
south: the Performance Stage
east: the Old Cage
west: the Storage Room

>n
Guard Room
A dark wooden table is in the middle of the room, a guard is sitting behind it, half-asleep. There is a small key on the table.

You can see a circus guard, a friends cage door and a metal key here.

>throw ball
The ball hits the wall with a loud thud. The guard stands up to investigate.

>l
Guard Room
A dark wooden table is in the middle of the room, a guard is sitting behind it, half-asleep. There is a small key on the table.

You can see a circus guard, a friends cage door and a metal key here.

south: the Hallway
east: the Friend's Cage

>use mirror
Light flashes down the hallway. The guard storms after it.

>take key
Taken.

>l
Guard Room
A dark wooden table is in the middle of the room, a guard is sitting behind it, half-asleep. There is a small key on the table.

You can see a friends cage door here.

south: the Hallway
east: the Friend's Cage

* * *

>e
It seems to be locked.

>use key on friend's cage
I only understood you as far as wanting to use the metal key.

>use key
You use the key. The lock clicks open.

>l
Guard Room
A dark wooden table is in the middle of the room, a guard is sitting behind it, half-asleep. There is a small key on the table.

You can see a friend and a friends cage door here.

south: the Hallway
east: the Friend's Cage

>e
Friend's Cage
Your friend looks at you approaching, he smiles knowing you came to save him.

Something long and rusty lies near the bars.

You can also see a friends cage door and a sewer grate here.

>l
Friend's Cage
Your friend looks at you approaching, he smiles knowing you came to save him.

Something long and rusty lies near the bars.

You can also see a friend, a friends cage door and a sewer grate here.

north: the Sewer Entrance
west: the Guard Room

>n
The grate blocks the way. Maybe you can pry it open with something.

>take something long and rusty
You can't see any such thing.

>take bar
You pick it up-it's a rusty crowbar.

>l
Friend's Cage
Your friend looks at you approaching, he smiles knowing you came to save him.

You can see a friend, a friends cage door and a sewer grate here.

north: the Sewer Entrance
west: the Guard Room

>pry open grate with crowbar
That's not a verb I recognise.

>open grate
It seems to be locked.

>use crowbar
Together you move the grate with a loud screech.

* * *

You wake up in a cold room, the floor is stone and you are surrounded by metal bars, it's a cage. Somewhere inside is your friend, you know you have to find him as soon as possible and escape.

Capybara Escape
An Interactive Fiction by Petra
Release 1 / Serial number 260118 / Inform 7 v10.1.2 / D

Capybara Cage
The bars are old but sturdy, in the distance you see light, it's the exit to the performance stage.

>n
You can't go that way.

>e
Performance Stage
The sandlike ground is littered with objects left behind by the audience. Peanut shells, old bananas and apples all around you.

Some peanut shells and a small pile of peanuts are scattered around.

You can also see an apple and a banana here.

>take banana
You pick up a ripe banana.

* * *

>take peanuts
You scoop up the peanuts.

>e
You can't go that way.

>n
Hallway
A narrow hallway stretches through the circus, dust and dirt covering the floor.

You see something round in the middle of the hallway.

>take something round
You can't see any such thing.

>take  round object
You can't see any such thing.

>take round object
You can't see any such thing.

>take ball
You pick it up-it's a ball.

* * *

>take peanuts
You scoop up the peanuts.

>n
Hallway
A narrow hallway stretches through the circus, dust and dirt covering the floor.

You see something round in the middle of the hallway.

* * *

>take round object
You pick it up-it's a ball.

>e
Old Cage
A small dark cage, there is a old capybara watching you.

You can see an old capybara here.

>talk to capybara
That's not a verb I recognise.

>ask capybara
What do you want to ask the old capybara for?

>ask capybara for hint
You can't see any such thing.

>ask capybara about key
There is no reply.

>give capybara banna
You can't see any such thing.

>eat banana
You eat the banana. It was filling but maybe you shouldn't have :(

>i
You are carrying:
  a ball
  some peanuts
  an apple

>inventory
You are carrying:
  a ball
  some peanuts
  an apple

* * *

You wake up in a cold room, the floor is stone and you are surrounded by metal bars, it's a cage. Somewhere inside is your friend, you know you have to find him as soon as possible and escape.

Capybara Escape
An Interactive Fiction by Petra
Release 1 / Serial number 260118 / Inform 7 v10.1.2 / D

Capybara Cage
The bars are old but sturdy, in the distance you see light, it's the exit to the performance stage.

>use something
You can't see any such thing.

>e
Performance Stage
The sandlike ground is littered with objects left behind by the audience. The stage is big enough to do a dance, you can even do a flip!

Some peanut shells and a small pile of peanuts are scattered around.

You can also see an apple and a banana here.

* * *

>take banana
You pick up a ripe banana.

Good thing you can store it in your inventory.

>use banana
You're not sure how to use that here.